yangTestTest
位图
	交换位图...		用另一个位图元件替换实例
	跟踪位图...		将位图对象转换成曲线

修改
	分离	Ctrl+B	将所选对象分解成原有的组成部分
	取消组合	Ctrl+Shift+G	取消组合所选组对象
	文档...	Ctrl+J	更改文档的大小和其他属性
	组	Ctrl+G	创建新的组对象
	转换为位图		将所选内容转换为位图
	转换为元件...	F8	从所选内容创建一个可在多个位置使用的新元件

元件
	交换元件...		用另一个元件替换实例
	导出 PNG 序列		导出 PNG 序列
	生成 Sprite 表...		生成 Sprite 表
	直接复制元件...		直接复制所选元件

变形
	任意变形		显示用来旋转或倾斜所选内容的手柄
	取消变形	Ctrl+Shift+Z	取消所选对象的所有旋转或缩放
	垂直翻转		上下翻转所选内容
	封套		显示用来封套所选内容的手柄
	扭曲		显示用来扭曲所选内容的手柄
	旋转与倾斜		显示用来旋转或倾斜所选内容的手柄
	水平翻转		左右翻转所选内容
	缩放		显示用来放大或缩小所选内容的手柄
	缩放和旋转...	Ctrl+Alt+S	使用数值缩放和/或旋转所选内容
	逆时针旋转 90 度	Ctrl+Shift+7	将所选内容左转 90 度
	顺时针旋转 90 度	Ctrl+Shift+9	将所选内容右转 90 度

合并对象
	交集		创建形状交集
	删除封套		删除扭曲或封套
	打孔		创建形状打孔
	联合		创建形状联合
	裁切		创建形状裁切

同步
	上次同步时间		上次同步时间
	立即同步		将设置同步到云中
	管理帐户		同步.管理 Creative Cloud 帐户
	管理设置		管理同步设置

命令
	作为放映文件导出		作为放映文件导出
	复制 ActionScript 的字体名称		复制 ActionScript 的字体名称
	导入动画 XML		导入动画 XML
	导出动画 XML		导出动画 XML
	将动画复制为 XML		将动画复制为 XML
	管理保存的命令...		修改保存的命令集
	获取更多命令...		通过 Flash Exchange 载入命令
	转换为其它文档格式		转换为其它文档格式
	运行命令...		运行 JavaScript 命令

字母间距
	减小	Ctrl+Alt+向左箭头	缩小字母间距
	增大	Ctrl+Alt+向右箭头	增大字母间距
	重置	Ctrl+Alt+向上箭头	将字母间距重置成默认值

定位
	上一个	Page Up	转到影片中的前一个场景
	上一个选项卡	Ctrl+Shift+Tab	选择前一个选项卡
	上一个面板焦点	Ctrl+Shift+F6	前一个面板焦点
	下一个	Page Down	转到影片中的下一个场景
	下一个选项卡	Ctrl+Tab	选择下一个选项卡
	下一个面板焦点	Ctrl+F6	下一个面板焦点
	场景		转到场景编辑模式
	将焦点返回舞台	Ctrl+Alt+Home	将焦点返回舞台
	最后一个	End	转到影片中的最后一个场景
	第一个	Home	转到影片中的第一个场景

对齐
	与舞台对齐	Ctrl+Alt+8	将所选内容与舞台对齐
	使宽度相同	Ctrl+Shift+Alt+7	使所选项目等宽
	使高度相同	Ctrl+Shift+Alt+9	使所选项目等高
	向右	Ctrl+Alt+3	将所选内容沿右边对齐
	向左	Ctrl+Alt+1	将所选内容沿左边对齐
	垂直居中	Ctrl+Alt+5	垂直居中对齐所选内容
	底部	Ctrl+Alt+6	将所选内容沿底边对齐
	按宽度均匀分布	Ctrl+Alt+7	按宽度均匀分布所选项目
	按高度均匀分布	Ctrl+Alt+9	按高度均匀分布所选项目
	水平居中	Ctrl+Alt+2	水平居中对齐所选内容
	顶部	Ctrl+Alt+4	将所选内容沿顶边对齐

导入
	导入到库...		将用其他应用程序创建的文件导入文档库
	导入到舞台...	Ctrl+R	将用其他应用程序创建的文件导入文档中
	导入视频...		将视频文件导入 Flash
	打开外部库...	Ctrl+Shift+O	以浮动的库窗口打开文档

导出
	导出图像...		将绘画保存为可以在其他应用程序中使用的格式
	导出影片...	Ctrl+Shift+Alt+S	将文档保存为可以在其他应用程序中使用的影片
	导出视频...		将文档另存为可在其他应用程序中使用的视频文件

屏幕模式
	全屏模式		全屏模式
	切换屏幕模式	F11	切换屏幕模式
	带有菜单栏的全屏模式		带有菜单栏的全屏模式
	标准屏幕模式	Esc	标准屏幕模式

工作区
	删除工作区		删除当前工作区
	新建工作区		创建新的工作区
	重置工作区		还原当前工作区

工具
	3D 旋转	Shift+W, W	3D 旋转工具
	3D 转换	Shift+G, G	3D 平移工具
	任意变形	Shift+Q, Q	任意变形工具
	全局转换	Shift+D, D	全局转换
	减小笔触大小	Shift+[, [	减小笔触大小
	基本椭圆	Shift+O, O	基本椭圆工具
	基本矩形	Shift+R, R	基本矩形工具
	增大笔触大小	Shift+], ]	增大笔触大小
	墨水瓶	Shift+S, S	墨水瓶工具
	套索	Shift+L, L	套索工具
	套索多边形	Shift+L, L	套索多边形工具
	子选区	Shift+A, A	部分选取工具
	宽度	Shift+U, U	宽度工具
	对象模型	Shift+J, J	对象绘制
	手形	Shift+H, H	手形工具
	文本	Shift+T, T	文本工具
	椭圆	Shift+O, O	椭圆工具
	橡皮擦	Shift+E, E	橡皮擦工具
	渐变变形	Shift+F, F	渐变转换工具
	滴管	Shift+I, I	滴管工具
	画笔	Shift+B, B	画笔工具
	矩形	Shift+R, R	矩形工具
	线条	Shift+N, N	线条工具
	绑定工具	Shift+M, M	绑定工具
	缩放	Shift+Z, Z	缩放工具
	选区	Shift+V, V	选取工具
	钢笔	Shift+P, P	钢笔工具
	钢笔删除锚点	Shift+-, -	删除锚点工具
	钢笔添加锚点	Shift+=, =	添加锚点工具
	钢笔转换锚点	Shift+C, C	转换锚点工具
	铅笔	Shift+Y, Y	铅笔工具
	颜料桶	Shift+K, K	颜料桶工具
	骨骼工具	Shift+M, M	骨骼工具
	魔术棒	Shift+L, L	魔术棒工具

工具栏
	编辑栏		显示或隐藏编辑栏

帮助
	Adobe 在线论坛		打开 Web 浏览器访问 Flash 在线论坛
	Flash Exchange		转到 Flash Exchange 网站
	Flash 帮助	F1	在 Web 浏览器中查看 Adobe Flash 帮助
	Flash 支持中心		打开您的 Web 浏览器，访问位于 Adobe.com 的 Flash 支持中心
	关于 Flash		显示程序信息、版本号和版权信息
	管理 Adobe AIR SDK...		允许用户管理 AIR SDK 的多个版本
	管理扩展...		启动 Adobe Extension Manager 以添加和删除扩展程序

形状
	优化...	Ctrl+Shift+Alt+C	平滑所选曲线，以便使用较少的资源
	伸直		伸直所选线条
	删除形状提示		删除补间形状提示
	删除所有提示		删除所有补间形状提示
	将线条转换为填充		将线条转换成实心区域
	平滑		平滑所选线条
	扩展填充...		展开或插入所选形状的边缘
	柔化填充边缘...		将所选形状的边缘混合成透明
	添加形状提示	Ctrl+Shift+H	添加补间形状提示
	高级伸直...	Ctrl+Shift+Alt+N	使用"高级伸直"对话框伸直所选线条
	高级平滑...	Ctrl+Shift+Alt+M	使用"高级平滑"对话框平滑所选线条

排列
	上移一层	Ctrl+向上箭头	将所选对象移到所有重叠对象的上方
	下移一层	Ctrl+向下箭头	将所选对象移到所有重叠对象的下方
	移至底层	Ctrl+Shift+向下箭头	将所选对象移至所在图层的最后面
	移至顶层	Ctrl+Shift+向上箭头	将所选对象移至所在图层的最前面
	解除全部锁定	Ctrl+Shift+Alt+L	将绘画中所有被锁定的对象解除锁定
	锁定	Ctrl+Alt+L	锁定所选对象，以防意外修改

控制
	停止		停止播放影片
	前进一帧	.	前进一帧
	后退	Shift+,	转到第一帧
	后退一帧	,	后退一帧
	启用简单按钮		测试影片中的按钮动作
	循环播放		循环播放动画
	播放	Return, Enter	播放影片
	播放所有场景		以连续动画的形式播放所有影片场景
	测试场景	Ctrl+Alt+Return, Ctrl+Alt+Enter	在测试模式中运行当前场景
	清除发布缓存		删除 ActionScript 对象文件
	清除发布缓存并测试影片		删除 ActionScript 对象文件并运行影片
	转到结尾	Shift+.	转到最后一帧
	静音	Ctrl+Alt+M	播放动画时静音

插入
	传统补间		将所选帧设置为传统补间动画
	创建补间动画		将所选帧设置为补间动画
	场景		在当前场景后添加新场景
	新建元件...	Ctrl+F8	创建可在多个位置使用的新元件
	补间动画		将所选帧设置为补间动画
	补间形状		将所选帧设置为补间形状

文件
	AIR 设置...		打开 Adobe AIR 应用程序和安装程序设置对话框
	ActionScript 设置...		打开 ActionScript 高级设置对话框
	保存	Ctrl+S	保存活动文档
	全部保存		保存所有文档
	全部关闭	Ctrl+Alt+W	关闭所有文档
	关闭	Ctrl+W	关闭活动文档
	发布	Shift+Alt+F12	以所选格式发布文档
	发布设置...	Ctrl+Shift+F12	修改发布设置
	另存为...	Ctrl+Shift+S	用新名称保存活动文档
	另存为模板...		将活动文档保存为模板
	在 Bridge 中浏览	Ctrl+Alt+O	转到 Bridge
	打开	Ctrl+O	打开现有文档
	新建...	Ctrl+N	选择一个新文档来创建
	还原		还原为上次保存的活动文档版本
	退出	Ctrl+Q	退出应用程序；提示保存文档

文本
	可滚动		切换文本字段可滚动模式
	字体嵌入...		打开字体嵌入对话框

文本大小
	10		将文本改成 10 磅字
	11		将文本改成 11 磅字
	12		将文本改成 12 磅字
	120		将文本改成 120 磅字
	14		将文本改成 14 磅字
	18		将文本改成 18 磅字
	24		将文本改成 24 磅字
	36		将文本改成 36 磅字
	48		将文本改成 48 磅字
	72		将文本改成 72 磅字
	8		将文本改成 8 磅字
	9		将文本改成 9 磅字
	96		将文本改成 96 磅字

文本对齐
	两端对齐	Ctrl+Shift+J	使文本两端对齐
	向右	Ctrl+Shift+R	使文本右对齐
	向左	Ctrl+Shift+L	使文本左对齐
	居中	Ctrl+Shift+C	使文本居中对齐

文本样式
	上标		将文本设为上标
	下标		将文本设为下标
	仿斜体		将文本设为仿斜体
	仿粗体		将文本设为仿粗体
	斜体	Ctrl+Shift+I	将文本设为斜体
	粗体	Ctrl+Shift+B	将文本设为粗体

时间轴
	使关键帧浮动		将关键帧切换为浮动
	使关键帧非浮动		将关键帧切换为非浮动
	分布到关键帧	Ctrl+Shift+K	将所选对象移动到各自的关键帧上
	分布到图层	Ctrl+Shift+D	将所选对象移动到各自的图层上
	删除帧	Shift+F5	删除所选帧
	剪切图层		剪切选中的图层
	剪切帧	Ctrl+Alt+X	剪切选中的帧
	另存为动画预设...		将动画对象另存为动画预设
	合并动画		将选定的运动范围合并到一个范围中
	同步元件		调整元件的第一帧，使之在关键帧间不断地循环
	图层属性...		编辑当前图层的属性
	复制动画		将所选帧复制为动画对象
	复制图层		直接复制选中的图层
	复制帧	Ctrl+Alt+C	复制选中的帧
	拆分动画		在所选帧处拆分运动范围
	插入关键帧		将关键帧的内容设置为与所选帧相同
	插入图层		在时间轴中插入新的图层
	插入图层文件夹		在时间轴中插入新的图层文件夹
	插入帧	F5	在所选图层中插入帧
	插入空白关键帧		在所选帧处创建空白关键帧
	清除关键帧	Shift+F6	删除所选关键帧
	清除帧	Alt+Backspace	删除所选帧内的对象
	粘贴动画		将动画对象粘贴到所选帧
	粘贴图层		从剪贴板粘贴图层
	粘贴帧	Ctrl+Alt+V	从帧剪贴板粘贴帧
	粘贴并覆盖帧		从帧剪贴板粘贴并覆盖帧
	翻转帧		倒转所选帧的先后顺序，使动画倒着播放
	翻转路径		反转运动路径
	转换为关键帧	F6	将所选帧转换为关键帧
	转换为空白关键帧	F7	将所选帧转换为空白关键帧
	选择性粘贴动画...		将动画对象粘贴到所选帧
	选择所有帧	Ctrl+Alt+A	选择当前场景或元件中的所有帧

测试影片
	在 AIR Debug Launcher（桌面）中		在 AIR 桌面中运行影片
	在 AIR Debug Launcher（移动设备）中		在 AIR 移动设备中运行影片
	在 Flash Professional 中		在 Flash Professional 中运行影片
	在 iOS 模拟器上		在 iOS 模拟器上运行影片
	在浏览器中		在浏览器中运行影片
	在通过 USB 连接的设备上		在通过 USB 连接的 AIR 移动设备中运行影片
	测试	Ctrl+Return, Ctrl+Enter	在所选的 Player 中运行影片

窗口
	代码片断		显示或隐藏"代码片断"面板
	信息	Ctrl+I	显示或更改所选对象的属性和位置
	动作	F9	显示或隐藏"动作"面板
	动画预设		显示或隐藏"动画预设"面板
	历史记录	Ctrl+F10	显示或隐藏"历史记录"面板
	变形	Ctrl+T	使用数值缩放和/或旋转所选内容
	场景	Shift+F2	显示或更改当前影片中的场景列表
	对齐	Ctrl+K	显示或隐藏"对齐"面板
	属性	Ctrl+F3	显示或隐藏属性检查器
	工具	Ctrl+F2	显示或隐藏绘画工具栏
	库	Ctrl+L	为该文档显示或隐藏"库"面板
	插件		浏览插件
	时间轴	Ctrl+Alt+T	显示或隐藏动画时间轴和图层控件
	样本	Ctrl+F9	从色样中选择颜色并管理色样
	直接复制窗口	Ctrl+Alt+K	在最前面的模拟中打开一个新窗口，它是活动窗口的副本
	组件	Ctrl+F7	Adobe 组件的窗口小部件
	编译器错误	Alt+F2	显示或隐藏"编译器错误"面板
	输出	F2	显示或隐藏"输出"面板
	隐藏面板	F4	显示或隐藏所有面板
	颜色	Ctrl+Shift+F9	显示或隐藏"颜色"面板

编辑
	使用主编辑器编辑		使用主编辑器编辑位图
	全选	Ctrl+A	选择整个绘画
	凸出代码	Ctrl+]	凸出选定的文本
	删除		删除当前所选内容
	剪切	Ctrl+X	剪切所选内容并将其放到剪贴板上
	反转选区		反转舞台选择项
	取消全选	Ctrl+Shift+A	取消选择绘画中的所有选定元素
	取消注释所选内容	Ctrl+Shift+M	取消注释所选文本
	向上移动所选内容	向上箭头	向上移动所选内容
	向下移动所选内容	向下箭头	向下移动所选内容
	向右移动所选内容	向右箭头	向右移动所选内容
	向左移动所选内容	向左箭头	向左移动所选内容
	在当前位置编辑	Ctrl+E	在当前位置编辑元件
	在新窗口中编辑元件		在新窗口中编辑所选元件
	复制	Ctrl+C	复制所选内容并将其放到剪贴板上
	字体映射...		为缺少字体的文本自定义字体映射
	快速向上移动所选内容	Shift+向上箭头	快速向上移动所选内容
	快速向下移动所选内容	Shift+向下箭头	快速向下移动所选内容
	快速向右移动所选内容	Shift+向右箭头	快速向右移动所选内容
	快速向左移动所选内容	Shift+向左箭头	快速向左移动所选内容
	撤消	Ctrl+Z	撤消上次操作
	查找上一个	Shift+F3	查找属于最初定义的类型的上一个项
	查找下一个	F3	查找属于最初定义的类型的下一个项
	查找和替换	Ctrl+F	查找和替换
	注释所选内容	Ctrl+M	注释所选文本
	清除	Del, Backspace	删除所选内容
	直接复制	Ctrl+D	直接复制所选内容
	粘贴	Ctrl+V	将剪贴板内容粘贴至文档
	粘贴到当前位置	Ctrl+Shift+V	插入剪贴板内容，但不在窗口内居中
	编辑元件		在编辑元件或影片场景之间切换
	编辑所选项		编辑所选对象的内容
	编辑方式...		使用选定编辑器编辑位图
	缩进代码	Ctrl+[	缩进选定的文本
	语法检查		语法检查
	转到行		转到特定行
	选择性粘贴		根据选择的格式粘贴剪贴板内容
	重做	Ctrl+Y	重做先前撤消的操作
	键盘快捷键...		自定义菜单和工具的键盘快捷键
	首选参数...	Ctrl+U	打开"首选参数"对话框

缩放比率
	100%	Ctrl+1	缩放到 100%
	200%		缩放到 200%
	25%		缩放到 25%
	400%	Ctrl+4	缩放到 400%
	50%		缩放到 50%
	800%	Ctrl+8	缩放到 800%
	显示全部	Ctrl+3	在窗口中显示绘画的完整内容
	显示帧	Ctrl+2	在窗口中显示整个帧
	符合窗口大小		缩放到符合窗口的大小
	舞台居中	Ctrl+0	滚动以将舞台居中

网格
	显示网格	Ctrl+'	显示或隐藏绘画网格
	编辑网格...	Ctrl+Alt+G	打开网格属性对话框

视图
	切换所有折叠		切换所有部分的折叠
	切换折叠		切换当前部分的折叠
	折叠边缘		显示折叠边缘
	放大	Ctrl+=, Ctrl+Num =	显示绘画中的较小区域（包含较多的细节）
	显示 FrameScript 导航器	Ctrl+Alt+[	显示帧脚本导航器
	显示 Tab 键顺序		显示或隐藏 Tab 键顺序
	显示代码提示	Ctrl+空格	显示代码提示
	显示形状提示	Ctrl+Alt+I	显示或隐藏补间形状提示
	标尺	Ctrl+Shift+Alt+R	显示或隐藏标尺
	粘贴板	Ctrl+Shift+W	显示或隐藏环绕舞台的粘贴板
	缩小	Ctrl+-, Ctrl+Num -	显示绘画中的较大区域（包含较少的细节）
	自动套用格式	Ctrl+Shift+F	自动设置编辑器代码格式
	自动换行		切换自动换行
	行号		切换行号显示
	隐藏字符	Ctrl+Shift+8	显示隐藏字符
	隐藏边缘	Ctrl+Shift+E	启用时将禁止突出显示所选项目

视图命令
	交换视频		使用其他视频替换某个实例
	在库中显示		在库中显示所选项

调试
	切换断点	Ctrl+Alt+B	切换断点
	删除所有断点	Ctrl+Shift+Alt+B	删除所有断点
	开始远程调试会话		开始 AS 3.0 的远程调试会话
	结束	Alt+F12	停止调试会话
	继续	Alt+F5	继续播放
	跳入	Alt+F6	跳入函数
	跳出	Alt+F8	跳出函数
	跳过	Alt+F7	跳过当前行

调试影片
	在 AIR Debug Launcher（桌面）中		在 AIR 桌面中运行影片并打开调试器
	在 AIR Debug Launcher（移动设备）中		在 AIR 移动设备中运行影片并打开调试器
	在 Flash Professional 中		在 Flash Professional 中运行影片并打开调试器
	在 iOS 模拟器上		在 iOS 模拟器上运行影片并打开调试器
	在通过 USB 连接的设备上		在通过 USB 连接的设备上运行影片并打开调试器
	调试	Ctrl+Shift+Return, Ctrl+Shift+Enter	在所选的 Player 中运行影片并打开调试器

调试面板
	变量		显示或隐藏"变量"面板
	调试控制台		显示或隐藏调试控制台

贴紧
	编辑贴紧方式	Ctrl+/	修改贴紧设置
	贴紧对齐		打开或关闭贴紧对齐
	贴紧至像素		打开或关闭贴紧至像素
	贴紧至对象	Ctrl+Shift+U	打开或关闭贴紧至对象和自动连接线条
	贴紧至网格	Ctrl+Shift+'	打开或关闭贴紧至网格
	贴紧至辅助线	Ctrl+Shift+;	打开或关闭贴紧至辅助线

辅助线
	显示辅助线	Ctrl+;	显示或隐藏辅助线
	清除辅助线		清除所有辅助线
	编辑辅助线...	Ctrl+Shift+Alt+G	打开辅助线属性对话框
	锁定辅助线	Ctrl+Alt+;	锁定或取消锁定辅助线

预览模式
	全部		显示文档的完整预览
	快速	Ctrl+Shift+Alt+F	显示文档的快速预览
	消除文字锯齿	Ctrl+Shift+Alt+T	在文档中消除文字和图形边缘的锯齿
	消除锯齿	Ctrl+Shift+Alt+A	在文档中消除边缘锯齿
	轮廓	Ctrl+Shift+Alt+O	只显示文档的概要

